11111111111111111111111111
100100000000000000000000C1
10000011110000000000110001
1P00011E000000000000000001
11111111111111111111111111