11111111111111111111111111
1P0100000000000000000000C1
10000011110000000000110001
1000011E000000000000C00001
10000110000000000000C00001
11111111111111111111111111