1111111111111111111111
1000000000000000000011
1P00000000E01111100001
11110111E1111111111111
1111111111111111111111