11111111111111
100100000000C1
10000011110001
1P00011E000001
11111111111111